0 0 0 0 0 0 0 0 0 0 0 0 0 0 0 0 0 0 0 0 0 0 0 0 0 0 0 0 0 0 0 0 0 0 0 0 0 0 0 0 0 0 0 0 0 0 0 0 0 0        
0 0 0 0 0 0 0 0 0 0 0 0 0 0 0 0 0 0 0 0 0 0 0 0 0 0 0 0 0 0 0 0 0 0 0 0 0 0 0 0 0 0 0 0 0 0 0 0 0 0               
0 1 1 1 2 2 2 2 2 0 2 2 2 2 2 2 2 2 2 2 2 2 2 2 2 2 2 2 2 2 2 2 2 2 2 2 2 2 2 2 2 2 2 2 2 2 2 2 0 0        
0 1 1 1 2 2 2 2 2 0 2 2 2 2 2 2 2 2 2 2 2 2 2 2 2 2 2 2 2 0 2 2 2 2 2 2 2 2 2 2 2 2 2 2 2 2 2 2 0 0        
0 1 1 2 1 2 2 2 2 0 2 2 2 2 2 2 2 2 2 2 2 2 2 2 2 2 2 2 0 0 2 2 2 0 0 0 0 0 0 2 2 2 2 2 2 2 2 2 0 0        
0 2 2 2 2 2 2 2 2 0 2 2 2 2 2 2 2 2 2 2 2 2 2 2 2 2 2 0 6 6 6 6 6 6 6 6 6 6 6 2 2 2 2 2 2 2 2 2 0 0        
0 2 2 2 2 2 2 2 2 0 2 2 2 2 2 2 2 2 2 2 2 2 2 2 2 2 2 0 6 5 5 5 5 5 5 5 5 5 6 2 2 2 2 2 2 2 2 2 0 0         
0 2 2 2 2 2 2 2 0 0 2 2 2 2 2 2 2 2 2 2 2 2 2 2 2 2 2 0 6 5 5 5 5 5 5 5 5 5 6 2 2 2 2 2 0 0 2 2 0 0        
0 2 2 2 2 2 2 2 0 2 2 2 2 2 2 2 2 2 2 2 2 2 2 2 2 2 2 0 6 5 5 5 5 5 5 5 5 5 6 2 2 2 2 2 2 0 2 2 0 0
0 2 2 2 2 2 2 2 0 2 2 2 2 2 2 2 2 2 2 2 2 2 2 2 2 2 2 0 6 5 5 5 5 5 5 5 5 5 6 2 2 2 2 2 2 2 2 2 0 0
0 2 2 2 2 2 2 2 0 2 2 2 2 2 2 2 2 2 2 2 2 2 2 2 2 2 2 0 6 6 6 6 6 6 6 6 6 6 6 2 2 2 2 2 2 2 2 2 0 0
0 2 2 2 2 2 2 2 0 2 2 2 2 2 2 2 2 2 2 2 2 2 2 2 2 2 2 2 2 2 2 2 2 2 2 2 2 2 2 2 2 2 2 2 2 2 2 2 0 0
0 2 2 2 2 2 2 2 0 2 2 2 2 2 2 2 2 2 2 2 2 2 2 2 2 2 2 2 2 2 2 2 2 2 2 2 2 2 2 2 2 2 2 2 2 2 2 2 0 0
0 2 2 2 2 2 2 2 0 2 2 2 2 2 2 0 2 2 2 0 2 2 2 2 2 2 2 2 2 2 2 2 2 2 2 2 2 2 2 2 2 2 2 2 2 2 2w 2 0 0
0 2 2 2 2 2 2 2 0 2 2 2 2 2 2 2 0 0 0 2 2 2 2 2 2 2 2 2 2 2 2 2 2 2 2 2 2 2 2 2 2 2 2 2 2 2 2 2 0 0
0 2 2 2 2 2 2 2 0 2 2 2 2 2 2 2 2 2 2 2 2 2 2 2 2 2 2 2 2 2 2 2 2 2 2 2 2 2 2 2 2 2 2 2 2 2 2 2 0 0
0 1 1 2 2 2 2 2 0 2 2 2 2 2 2 2 2 2 2 2 2 2 2 2 2 2 2 2 2 2 2 2 2 2 2 2 2 2 2 2 2 2 2 2 2 2 2 2 0 0
0 1 1 2 2 2 2 2 0 2 2 2 2 2 2 2 2 2 2 2 2 2 2 2 2 2 2 2 2 2 2 2 2 2 2 2 2 2 2 2 2 2 2 2 2 2 2 2 0 0
0 1 1 2 2 2 2 2 0 2 2 2 2 2 2 2 2 2 2 2 2 2 2 2 2 2 2 2 2 2 2 2 2 2 2 2 2 2 2 2 2 2 2 2 2 2 2 2 0 0
0 1 1 2 2 2 2 2 2 6 5 5 5 5 5 5 5 2 2 2 2 2 2 2 2 2 2 2 2 2 2 2 2 2 2 2 2 2 2 2 2 2 2 2 2 2 2 2 0 0
0 1 1 2 2 2 2 2 2 5 5 5 5 5 5 5 5 2 2 2 2 2 2 2 2 2 2 2 2 2 2 2 2 2 2 2 2 2 2 2 2 2 2 2 2 2 2 2 0 0
0 2 1 2 2 2 2 2 2 5 5 5 5 5 5 5 5 2 2 2 2 2 2 2 2 2 2 2 2 2 2 2 2 2 2 2 2 2 2 2 2 2 2 2 2 2 2 2 0 0
0 2 2 2 2 2 2 2 2 5 5 5 5 5 5 5 5 2 2 2 2 2 2 2 2 2 2 2 2 2 2 2 2 2 2 2 2 2 2 2 2 2 2 2 2 2 2 2 0 0
0 2 2 1 2 2 2 2 2 2 2 2 2 2 2 2 2 2 2 2 2 2 8 8 8 8 8 8 8 8 8 8 8 8 8 8 2 2 2 2 2 2 2 2 2 2 2 2 0 0
0 2 1 2 2 2 2 2 2 2 2 2 2 2 2 2 2 2 2 2 2 2 8 4 4 4 4 4 4 4 4 4 4 4 4 8 2 2 2 2 2 2 2 2 2 2 2 2 0 0
0 1 2 2 2 2 2 2 2 2 2 2 2 2 2 2 2 2 2 2 2 2 8 4 4 4 4 4 4 4 4 4 4 4 4 8 2 2 2 2 2 2 2 2 2 2 2 2 0 0
0 2 2 2 2 2 2 2 2 2 2 2 2 2 2 2 2 2 2 2 2 2 8 4 4 4 4 4 4 4 4 4 4 4 4 8 2 2 2 2 2 2 2 2 2 2 2 2 0 0
0 2 2 2 2 2 2 2 2 2 2 2 2 2 2 2 2 2 2 2 2 2 8 8 8 8 8 8 8 8 8 4 4 4 4 8 2 2 2 2 2 2 2 2 2 2 2 2 0 0
0 2 2 2 2 2 2 2 2 2 2 2 2 2 2 2 2 2 2 2 2 2 2 2 2 2 2 2 2 2 8 4 4 4 4 8 2 2 2 2 2 2 2 2 2 2 2 2 0 0
0 2 2 2 2 2 2 2 6 6 6 6 6 6 6 6 6 6 6 6 2 2 2 0 2 2 2 2 2 2 8 4 4 4 4 8 2 2 2 2 2 2 2 2 2 2 2 2 0 0
0 2 2 2 2 2 2 2 5 5 5 5 5 5 5 5 5 5 5 6 2 2 2 0 2 2 2 2 2 2 8 4 4 4 4 8 2 2 2 2 2 2 2 2 2 2 2 2 0 0
0 2 2 2 2 2 2 2 5 5 5 5 5 5 5 5 5 5 5 6 2 2 2 0 2 2 2 2 2 2 8 4 4 4 4 8 2 2 2 6 6 6 6 2 2 2 2 2 0 0
0 2 2 2 2 2 2 2 5 5 5 5 5 5 5 5 5 5 5 6 2 2 2 0 2 2 2 2 2 2 8 4 4 4 4 8 2 2 2 6 5 5 6 2 2 2 2 2 0 0
0 2 2 2 2 2 2 2 5 5 5 5 5 5 5 5 5 5 5 6 2 2 2 0 2 2 2 2 2 2 8 4 4 4 4 8 2 2 2 6 5 5 6 2 2 2 2 2 0 0
0 2 2 2 2 2 2 2 5 5 5 5 5 5 5 5 5 5 5 6 2 2 2 0 2 2 2 2 2 2 8 4 4 4 4 8 2 2 2 6 6 6 6 2 2 2 0 0 0 0
0 2 2 2 2 2 2 2 6 5 5 5 5 5 5 5 5 5 5 6 2 2 2 0 2 2 2 2 2 2 8 4 4 4 4 8 2 2 2 2 2 2 2 2 2 2 0 0 0 0
0 2 2 2 2 2 2 2 2 2 2 2 2 2 2 2 2 2 2 2 2 2 0 0 2 2 2 2 2 2 8 4 4 4 4 8 2 2 2 2 2 2 2 2 2 2 2 2 0 0
0 2 2 2 2 2 2 2 2 2 2 2 2 2 2 2 2 2 2 2 2 2 0 0 2 2 2 2 2 2 8 4 4 4 4 8 2 2 2 2 2 2 2 2 2 2 2 2 0 0
0 2 2 2 2 2 2 2 2 2 2 2 2 2 2 2 2 2 2 2 2 2 0 0 2 2 2 2 2 2 8 4 4 4 4 8 2 2 2 2 2 2 2 2 2 2 2 2 0 0
0 2 2 2 2 2 2 2 2 2 2 2 2 2 2 2 2 2 2 2 2 2 0 0 2 2 2 2 2 2 8 4 4 4 4 8 2 2 2 2 2 2 2 2 2 2 2 2 0 0
0 2 2 2 2 2 2 2 2 2 2 2 2 2 2 2 2 2 2 2 2 2 0 0 2 2 2 2 2 2 8 4 4 4 4 8 2 2 2 2 2 2 2 2 2 2 2 2 0 0
0 2 6 6 6 6 6 0 0 0 0 0 2 2 2 2 2 2 2 2 0 0 0 0 2 2 2 2 2 2 2 7 7 7 7 8 2 2 2 2 2 2 2 2 2 2 2 2 0 0
0 2 6 5 5 5 6 0 0 0 0 0 2 2 2 2 2 2 2 2 0 0 0 0 2 2 2 2 2 2 2 2 2 2 2 2 2 2 2 0 0 0 0 0 0 0 2 2 0 0
0 0 6 5 5 5 6 0 0 0 0 0 2 2 2 2 2 2 2 2 0 0 0 0 2 2 2 2 2 2 2 2 2 2 2 2 2 2 2 0 0 0 0 0 0 0 2 2 0 0
0 0 6 5 5 5 6 0 0 0 0 0 2 2 2 2 2 2 2 2 0 0 0 0 2 2 2 2 2 2 2 2 2 2 2 2 2 2 2 2 2 2 2 2 2 2 2 2 0 0
0 0 6 6 6 6 6 0 0 0 0 0 2 2 2 2 2 2 2 2 0 0 0 0 2 2 2 2 2 2 2 2 2 2 2 2 2 2 2 2 2 2 2 2 2 2 2 2 0 0
0 0 2 2 2 2 2 2 2 2 2 2 2 2 2 2 2 2 2 2 0 0 0 0 2 2 2 2 2 2 2 2 2 2 2 2 2 2 2 2 2 2 2 2 2 2 2 2 0 0
0 0 2 2 2 2 2 2 2 2 2 2 2 2 2 2 2 2 2 2 0 0 0 0 2 2 2 2 2 2 2 2 2 2 2 2 2 2 2 2 2 2 2 2 2 2 2 2 0 0
0 0 0 0 0 0 0 0 0 0 0 0 0 0 0 0 0 0 0 0 0 0 0 0 0 0 0 0 0 0 0 0 0 0 0 0 0 0 0 0 0 0 0 0 0 0 0 0 0 0
0 0 0 0 0 0 0 0 0 0 0 0 0 0 0 0 0 0 0 0 0 0 0 0 0 0 0 0 0 0 0 0 0 0 0 0 0 0 0 0 0 0 0 0 0 0 0 0 0 0