84 84 84 84 84 84 84 84 84 84 84 84 84 84 84 84 84 84 84 84 84 84 84 84 84 84 84 84 84 84 84 84 84 84 84 84 84 84 84 84 84 84 84 84 84 84 84 84 84 84 84 84 84 84 84 84 84
84 84 84 84 84 84 84 84 84 84 84 84 84 84 84 84 84 84 84 84 84 84 84 84 84 84 84 84 84 84 84 84 84 84 84 84 84 84 84 84 84 84 84 84 84 84 84 84 84 84 84 84 84 84 84 84 84
84 84 84 84 84 84 84 84 84 84 84 84 84 84 84 84 84 84 84 84 84 84 84 84 84 84 84 84 84 84 84 84 84 84 84 84 84 84 84 84 84 84 84 84 84 84 84 84 84 84 84 84 84 84 84 84 84
84 84 84 84 84 84 84 84 84 84 84 84 84 84 84 84 84 84 84 84 84 84 84 84 84 84 84 84 84 84 84 84 84 84 84 84 84 84 84 84 84 84 84 84 84 84 84 84 84 84 84 84 84 84 84 84 84
84 84 84 84 84 84 84 84 84 84 84 84 84 84 84 84 84 84 84 84 84 84 84 84 84 84 84 84 84 84 84 84 84 84 84 84 84 84 84 84 84 84 84 84 84 84 84 84 84 84 84 84 84 84 84 84 84
84 84 84 84 84 84 84 84 84 84 84 84 84 84 84 84 84 84 84 84 84 84 84 84 84 84 84 84 84 84 84 84 84 84 84 84 84 84 84 84 89 81 81 91 84 84 84 84 84 84 84 84 84 84 84 84 84
84 84 84 84 84 84 84 84 84 84 84 84 84 84 84 84 84 84 84 84 84 84 84 84 84 84 84 84 84 84 84 84 84 84 84 84 89 81 81 81 88 11 12 83 89 81 81 81 81 81 84 84 84 84 84 84 84
84 84 84 84 84 84 84 84 84 89 81 81 81 91 89 81 81 81 81 81 91 84 84 84 84 84 84 84 84 84 84 84 89 81 81 81 88 11 12 11 12 13 14 86 88 10 10 10 10 10 10 10 10 10 10 10           
84 84 84 84 84 84 84 84 84 85 32 31 33 86 88 32 31 31 31 33 83 84 84 84 84 84 84 84 84 84 84 84 85 32 31 31 31 13 14 13 14 21 22 11 12 11 12 11 12 11 12 11 12 11 12 11 12          
84 84 84 84 84 84 84 84 84 85 35 20 36 31 31 34 10 20 20 35 83 84 84 84 84 89 81 81 81 81 81 81 88 35 20 20 70 15 16 15 16 23 24 13 14 13 14 13 14 13 14 13 14 13 14 13 14     
84 84 84 84 84 84 89 81 81 88 35 20 20 20 20 20 10 20 20 35 86 81 81 81 91 85 32 31 31 31 31 31 31 34 20 20 10 20 10 70 70 15 16 21 22 21 22 21 22 21 22 21 22 21 22 15 16    
84 84 84 84 84 84 85 32 31 31 34 10 20 20 20 20 10 20 20 36 31 31 31 33 86 88 35 20 20 20 20 20 20 20 20 10 10 20 20 10 10 70 70 23 24 23 24 23 24 23 24 23 24 23 24 23 24       
84 84 84 84 84 84 85 35 11 12 20 20 20 20 20 20 10 20 20 20 20 20 20 36 31 31 34 20 20 20 20 20 20 20 20 10 60 60 60 60 10 70 70 15 16 15 16 15 16 15 16 15 16 15 16 15 16           
84 84 84 84 84 84 85 35 13 14 20 20 20 20 20 20 10 20 20 20 20 20 20 20 20 20 20 20 20 20 20 20 20 20 10 60 80 80 80 80 80 80 80 80 80 60 20 20 35 20 20 20 35 20 20 10 10           
84 84 84 84 84 84 85 35 15 16 20 20 20 20 20 10 10 20 20 20 20 20 20 20 20 20 20 20 20 20 20 20 20 20 10 60 80 80 80 80 80 80 80 80 80 60 20 20 36 31 31 31 34 20 20 10 10           
84 84 84 84 84 84 85 35 11 12 20 20 20 20 20 10 20 20 20 20 20 20 20 20 20 20 20 20 20 20 20 20 20 20 10 60 80 80 80 80 80 80 80 80 80 60 20 20 20 20 20 20 10 20 32 31 10  
84 84 84 84 84 84 85 35 13 14 20 20 20 20 20 10 20 20 20 20 20 20 20 20 20 20 20 20 20 20 20 20 20 20 10 60 90 80 80 80 80 80 80 80 80 60 20 20 20 20 20 20 20 20 35 10 10  
84 84 84 84 84 84 85 35 21 22 20 20 20 20 20 10 20 20 20 20 20 20 20 20 20 20 20 20 20 20 20 20 20 20 10 60 60 60 60 60 60 60 60 60 60 60 20 20 20 20 20 20 20 20 35 10 10  
84 84 84 84 84 84 85 35 23 24 20 20 20 20 20 10 20 20 20 20 20 20 20 20 20 20 20 20 20 20 20 20 20 20 20 20 20 20 20 20 20 20 20 20 20 20 20 20 20 20 20 20 20 20 35 10 10  
84 84 84 84 84 84 85 35 15 16 20 20 20 20 20 10 20 20 20 20 20 20 20 20 20 20 20 20 20 20 20 20 20 20 20 20 20 20 20 20 20 20 20 20 20 20 20 20 20 32 31 31 31 31 34 10 10  
84 84 84 84 84 84 85 35 60 20 20 20 20 20 20 10 20 20 20 20 20 20 10 20 20 20 10 20 20 20 20 20 20 20 20 20 20 20 20 20 20 20 20 20 20 20 20 20 20 35 20 20 20 20 20 10 10  
84 84 84 84 84 84 85 35 60 20 20 20 20 20 20 10 10 10 20 20 20 20 20 20 20 20 20 20 20 20 20 20 20 20 20 20 20 20 20 20 20 20 20 20 20 20 20 20 20 36 33 20 20 20 20 10 10  
84 84 84 84 84 84 85 35 60 20 20 20 20 20 20 10 20 20 20 20 20 20 20 20 20 20 20 20 20 20 20 20 20 20 20 20 20 20 20 20 20 20 20 20 20 20 20 20 20 20 35 20 20 20 20 10 10  
84 84 84 84 84 84 85 35 60 10 20 20 20 20 20 10 20 20 20 20 20 20 20 20 20 20 20 20 20 20 20 20 20 20 20 20 20 20 20 20 20 20 20 20 20 20 20 20 20 20 35 20 20 20 20 10 10  
84 84 84 84 84 84 85 35 11 12 20 20 20 20 20 10 20 20 20 20 20 20 20 20 20 20 20 20 20 20 20 20 20 20 20 20 20 20 20 20 20 20 20 20 20 20 20 20 32 31 34 20 20 20 20 10 10  
84 84 84 84 84 84 85 36 13 14 20 20 20 20 20 10 20 20 20 20 20 44 44 44 44 20 20 20 20 20 20 20 20 20 20 20 20 20 20 20 20 20 20 20 20 20 20 20 35 20 20 20 20 20 20 10 10  
84 84 84 84 84 84 90 82 21 22 20 20 20 20 20 20 60 80 41 42 45 45 45 45 20 20 20 20 20 20 20 20 20 20 20 20 20 20 20 20 20 20 20 20 20 20 35 20 20 20 20 20 20 10 10  
84 84 84 84 84 84 84 85 23 24 20 20 20 20 20 20 80 80 43 44 45 45 45 45 20 20 20 20 20 20 20 20 20 20 20 20 20 20 20 20 20 20 20 20 20 20 35 20 20 20 20 20 20 10 10  
84 84 84 84 84 84 84 85 15 16 20 20 20 20 20 20 80 80 80 80 45 45 45 45 20 20 20 20 20 20 20 20 20 20 20 20 20 20 20 20 20 20 20 20 20 20 35 20 20 20 20 20 20 10 10  
84 84 84 84 84 84 84 85 10 20 20 20 20 20 20 20 80 80 80 80 45 45 45 45 20 20 20 20 20 20 20 20 20 20 20 20 20 20 20 20 20 20 20 20 20 20 35 20 20 20 20 20 20 10 10  
84 84 84 84 84 84 84 85 10 20 10 20 20 20 20 20 20 20 20 20 46 46 46 46 20 20 20 20 80 80 80 80 80 80 80 80 80 80 80 80 80 80 20 20 20 20 20 35 20 20 20 20 20 20 10 10  
84 84 84 84 84 84 84 85 10 10 20 20 20 20 20 20 20 20 20 20 20 20 20 20 20 20 20 20 20 11 12 11 11 11 11 70 70 70 70 70 70 70 80 20 20 20 20 20 35 20 20 20 20 20 20 10 10  
84 84 84 84 84 84 84 85 10 20 20 20 20 20 20 20 20 20 20 20 20 20 20 20 20 20 20 20 20 13 14 70 70 70 70 70 70 70 70 70 70 70 80 20 20 20 20 20 35 20 20 20 20 20 20 10 10  
84 84 84 84 84 84 84 85 11 12 20 20 20 20 20 20 20 20 20 20 20 20 20 11 12 20 20 20 20 15 16 70 70 70 70 70 70 70 70 70 70 70 80 20 20 20 20 20 36 31 31 31 31 31 33 10 10  
84 84 84 84 84 84 84 85 13 14 20 20 20 20 20 20 20 20 20 20 20 20 20 13 14 20 20 20 20 80 80 80 80 80 80 80 80 80 70 70 70 70 80 20 20 20 20 20 20 20 20 20 20 20 35 10 10  
84 84 84 84 84 84 84 85 21 22 20 20 20 20 20 20 20 20 20 20 20 20 20 15 16 20 20 20 20 20 20 20 20 20 20 20 20 80 70 70 70 70 80 20 20 20 20 20 20 20 20 20 20 20 35 10 10  
84 84 84 84 84 84 84 85 23 24 20 20 20 20 20 60 30 30 30 30 30 30 30 30 30 30 60 20 20 20 10 20 20 20 20 20 20 80 70 70 70 70 80 20 20 20 20 20 20 20 20 20 20 20 35 10 10  
84 84 84 84 84 84 84 85 15 16 70 60 20 20 70 80 87 87 87 87 87 87 87 87 82 60 20 20 20 10 20 20 20 20 20 20 80 70 70 70 70 80 20 20 20 60 60 60 60 20 20 20 35 20 10 10  
84 84 84 84 84 84 84 85 11 12 11 12 20 20 20 83 84 84 84 84 84 84 84 84 85 60 60 20 20 20 10 20 20 20 20 20 20 80 70 70 70 70 80 20 20 20 60 80 80 60 20 35 20 20 20 10 10  
84 84 84 84 84 84 84 85 13 14 13 14 20 20 20 86 81 91 84 84 84 84 84 84 85 60 60 20 20 20 10 20 20 20 20 20 20 80 70 70 70 70 80 20 20 20 60 80 80 60 20 35 20 20 20 10 10  
84 84 84 84 84 84 84 85 21 22 21 22 20 20 20 11 12 80 87 87 84 84 84 84 85 60 60 20 20 20 10 20 20 20 20 20 20 80 70 70 70 70 80 20 20 20 60 60 60 60 20 35 20 10 10 10 10  
84 84 84 84 84 84 84 85 23 24 23 24 20 20 20 13 14 83 81 81 81 81 81 81 88 60 60 20 20 20 10 20 20 20 20 20 20 80 70 70 70 70 80 20 20 20 20 20 20 20 20 35 20 10 10 10 10  
84 84 84 84 84 84 84 85 15 16 15 16 80 87 82 15 16 83 10 20 20 20 20 20 20 20 20 10 10 10 10 20 20 20 20 20 20 20 20 20 20 20 20 20 10 10 10 10 10 20 35 10 10 10 10 10 10  
84 84 84 84 84 84 84 90 87 87 87 87 89 84 90 87 87 13 87 87 87 87 87 87 87 87 87 87 87 87 87 34 10 10 10 10 10 10 10 10 10 10 10 10 10 10 10 10 10 10 10 10 10 10 10 10 10
84 84 84 84 84 84 84 84 84 84 84 84 84 84 84 84 84 84 84 84 84 84 84 84 84 84 84 84 84 84 84 84 84 84 84 84 84 84 84 84 84 84 84 84 84 84 84 84 84 84 84 84 84 84 84 84 84 
84 84 84 84 84 84 84 84 84 84 84 84 84 84 84 84 84 84 84 84 84 84 84 84 84 84 84 84 84 84 84 84 84 84 84 84 84 84 84 84 84 84 84 84 84 84 84 84 84 84 84 84 84 84 84 84 84
84 84 84 84 84 84 84 84 84 84 84 84 84 84 84 84 84 84 84 84 84 84 84 84 84 84 84 84 84 84 84 84 84 84 84 84 84 84 84 84 84 84 84 84 84 84 84 84 84 84 84 84 84 84 84 84 84
84 84 84 84 84 84 84 84 84 84 84 84 84 84 84 84 84 84 84 84 84 84 84 84 84 84 84 84 84 84 84 84 84 84 84 84 84 84 84 84 84 84 84 84 84 84 84 84 84 84 84 84 84 84 84 84 84
84 84 84 84 84 84 84 84 84 84 84 84 84 84 84 84 84 84 84 84 84 84 84 84 84 84 84 84 84 84 84 84 84 84 84 84 84 84 84 84 84 84 84 84 84 84 84 84 84 84 84 84 84 84 84 84 84
84 84 84 84 84 84 84 84 84 84 84 84 84 84 84 84 84 84 84 84 84 84 84 84 84 84 84 84 84 84 84 84 84 84 84 84 84 84 84 84 84 84 84 84 84 84 84 84 84 84 84 84 84 84 84 84 84