84 84 84 84 84 84 84 84 84 84 84 84 84 84 84 84 84 84 84 84 84 84 84 84 84 84 84 84 84 84 84 84 84 84 84 84 84 84 84 84 84 84 84 84 84 84 84 84 84 84 
84 84 84 84 84 84 84 84 84 84 84 84 84 84 84 84 84 84 84 84 84 84 84 84 84 84 84 84 84 84 84 84 84 84 84 84 84 84 84 84 84 84 84 84 84 84 84 84 84 84 
84 84 84 84 84 84 84 84 84 84 84 84 84 84 84 84 84 84 84 84 84 84 84 84 84 84 84 84 84 84 84 84 84 84 84 84 84 84 84 84 84 84 84 84 84 84 84 84 84 84 
84 84 84 84 84 84 84 84 84 84 84 84 84 84 84 84 84 84 84 84 84 84 84 84 84 84 84 84 84 84 84 84 84 84 84 84 84 84 84 84 84 84 84 84 84 84 84 84 84 84    
84 84 84 84 84 84 84 84 84 84 84 84 84 84 84 84 84 84 84 84 84 84 84 84 84 84 84 84 84 84 84 84 84 84 84 84 84 84 84 84 84 84 84 84 84 84 84 84 84 84    
84 84 84 84 84 84 84 84 84 84 84 84 84 84 84 84 84 84 84 84 84 84 84 84 84 84 84 84 84 84 84 84 84 84 84 84 84 84 84 84 89 81 81 91 84 84 84 84 84 84    
84 84 84 84 84 84 84 84 84 84 84 84 84 84 84 84 84 84 84 84 84 84 84 84 84 84 84 84 84 84 84 84 84 84 84 84 89 81 81 81 88 11 12 83 89 81 81 81 81 81    
84 84 84 84 84 84 84 84 84 89 81 81 81 91 89 81 81 81 81 81 91 84 84 84 84 84 84 84 84 84 84 84 89 81 81 81 88 11 12 11 12 13 14 86 88 10 10 10 10 10 79            
84 84 84 84 84 84 84 84 84 85 32 31 33 86 88 32 31 31 31 33 83 84 84 84 84 84 84 84 84 84 84 84 85 32 31 31 31 13 14 13 14 21 22 11 12 11 12 11 12 11           
84 84 84 84 84 84 84 84 84 85 35 20 36 31 31 34 10 43 43 35 83 84 84 84 84 89 81 81 81 81 81 81 88 35 46 20 70 15 16 15 16 23 24 13 14 13 14 13 14 13      
84 84 84 84 84 84 89 81 81 88 35 20 20 20 20 20 10 44 44 35 86 81 81 81 91 85 32 31 31 31 31 31 31 34 20 20 10 10 10 70 70 15 16 21 22 21 22 21 22 21     
84 84 84 84 84 84 85 32 31 31 34 10 105 106 107 108 10 45 45 36 31 31 31 33 86 88 35 20 121 122 20 20 20 20 10 11 12 20 01 02 03 70 70 23 24 23 24 23 24 23        
84 84 84 84 84 84 85 35 11 12 71 20 109 110 111 112 10 20 20 20 20 20 20 36 31 31 34 20 123 124 20 20 11 12 20 13 14 60 04 05 06 70 70 15 16 15 16 15 16 15            
84 84 84 84 84 84 85 35 13 14 20 20 113 114 115 116 41 20 11 12 11 12 20 20 20 20 20 20 20 20 20 20 13 14 10 15 16 10 07 08 09 11 12 20 20 60 20 20 11 12            
84 84 84 84 84 84 85 35 15 16 20 20 117 118 119 120 42 20 13 14 13 14 20 20 11 12 20 20 20 20 20 20 15 16 10 10 60 30 20 20 20 13 14 11 12 60 20 20 13 14            
84 84 84 84 84 84 85 35 11 12 20 20 20 20 20 10 20 20 21 22 21 22 20 20 13 14 20 125 126 127 128 20 79 105 106 107 108 20 20 11 12 15 16 13 14 60 20 20 21 22   
84 84 84 84 84 84 85 35 13 14 20 20 20 20 20 10 20 20 23 24 23 24 20 20 21 22 20 129 130 131 132 20 70 109 110 111 112 20 70 13 14 20 20 15 16 60 20 20 23 24   
84 84 84 84 84 84 85 35 21 22 20 11 12 11 12 10 20 20 15 16 15 16 20 20 23 24 20 133 134 135 136 20 70 113 114 115 116 20 20 15 16 11 12 11 12 11 12 11 12 11   
84 84 84 84 84 84 85 35 23 24 20 13 14 13 14 10 17 18 19 25 26 27 28 20 15 16 20 137 138 139 140 20 71 117 118 119 120 20 20 60 20 13 14 13 24 13 14 13 14 13   
84 84 84 84 84 84 85 35 15 16 20 21 22 21 22 10 29 37 38 39 47 48 49 20 20 20 20 20 20 20 20 20 20 20 20 20 20 20 20 20 20 21 22 21 22 21 22 21 22 21   
84 84 84 84 84 84 85 35 76 20 20 23 24 23 24 10 61 62 63 64 65 66 67 20 76 20 10 20 11 12 20 51 52 20 20 11 12 20 20 79 20 23 24 23 24 23 24 23 24 23   
84 84 84 84 84 84 85 35 77 20 20 15 16 15 16 10 68 69 93 94 95 96 97 20 77 20 11 12 13 14 20 53 54 20 20 13 14 20 20 20 20 21 22 21 22 21 22 21 22 21   
84 84 84 84 84 84 85 35 78 20 20 20 20 20 20 10 98 99 100 101 102 103 104 20 78 20 13 14 15 16 20 55 56 20 20 15 16 20 20 20 20 23 24 23 24 23 24 23 24 23   
84 84 84 84 84 84 85 35 71 10 20 20 20 20 20 10 20 20 20 20 20 20 20 20 20 20 15 16 11 12 20 57 58 20 20 20 20 11 12 20 20 21 22 21 22 15 16 21 22 21   
84 84 84 84 84 84 85 35 11 12 20 20 79 20 20 10 20 11 12 20 20 20 20 20 20 20 20 20 23 24 20 20 20 20 20 20 20 13 14 20 20 23 24 23 24 51 52 23 24 23   
84 84 84 84 84 84 85 36 13 14 20 20 125 126 127 128 20 13 14 51 52 10 10 11 12 20 20 20 15 16 125 126 127 128 20 20 20 15 16 20 20 21 22 21 22 53 54 21 22 21 45   
84 84 84 84 84 84 90 82 21 22 20 20 129 130 131 132 60 21 22 53 54 10 10 13 14 20 20 20 11 12 129 130 131 132 11 12 20 20 20 20 20 23 24 23 24 55 56 23 24 23 
84 84 84 84 84 84 84 85 23 24 20 20 133 134 135 136 10 23 24 55 56 10 10 15 16 20 20 20 13 14 133 134 135 136 13 14 20 20 20 20 20 21 22 21 22 57 58 21 22 21 
84 84 84 84 84 84 84 85 15 16 20 20 137 138 139 140 10 15 16 57 58 70 30 30 20 20 20 20 21 22 137 138 139 140 21 22 20 20 20 20 20 23 24 23 24 20 60 23 24 23 
84 84 84 84 84 84 84 85 79 20 20 20 20 20 20 20 10 10 10 30 71 30 30 30 20 20 20 20 23 24 79 20 20 20 23 24 20 10 71 20 20 21 22 21 22 11 12 15 16 15
84 84 84 84 84 84 84 85 10 20 10 20 20 20 20 20 11 12 20 20 30 30 20 20 20 20 20 20 15 16 60 10 10 20 15 16 10 11 12 20 20 23 24 23 24 13 14 80 87 87   
84 84 84 84 84 84 84 85 10 10 20 11 12 20 20 20 13 14 20 20 20 20 20 20 20 20 20 20 20 10 10 10 10 10 60 20 30 13 14 20 70 15 16 15 16 21 22 83 84 84   
84 84 84 84 84 84 84 85 10 20 20 13 14 20 20 20 15 16 20 20 20 20 20 20 20 20 20 20 20 11 12 70 10 10 10 20 30 21 22 20 20 74 75 20 20 23 24 83 84 84   
84 84 84 84 84 84 84 85 11 12 20 21 22 20 41 121 122 20 20 20 20 20 20 11 12 20 20 20 20 13 14 10 10 11 12 20 30 23 24 20 30 30 79 20 20 15 16 83 84 84   
84 84 84 84 84 84 84 85 13 14 20 23 24 20 42 123 124 20 20 20 20 20 20 13 14 20 20 20 20 15 16 60 10 13 14 10 10 15 16 20 30 30 72 80 87 87 87 92 84 84    
84 84 84 84 84 84 84 85 21 22 20 15 16 20 20 20 20 20 20 20 11 12 20 15 16 20 20 20 20 11 12 20 20 15 16 20 20 10 20 20 30 30 73 83 84 84 84 84 84 84   
84 84 84 84 84 84 84 85 23 24 20 20 20 20 01 02 03 30 72 30 13 14 30 30 30 30 60 20 20 13 14 20 105 106 107 108 20 10 20 20 30 30 79 83 84 84 84 59 84 84   
84 84 84 84 84 84 84 85 15 16 70 60 20 20 04 05 06 10 73 10 15 16 10 20 20 30 11 12 20 21 22 20 109 110 111 112 20 10 20 20 30 30 72 83 84 84 84 84 84 84   
84 84 84 84 84 84 84 85 11 12 11 12 20 20 07 08 09 10 10 10 70 70 10 11 12 70 13 14 20 23 24 10 113 114 115 116 20 11 12 20 30 30 73 86 81 81 81 91 11 12   
84 84 84 84 84 84 84 85 13 14 13 14 20 20 20 20 10 10 10 10 20 20 20 13 14 71 15 16 20 15 16 20 117 118 119 120 20 13 14 20 20 20 79 70 70 20 20 86 13 14    
84 84 84 84 84 84 84 85 21 22 21 22 20 20 20 11 12 10 10 10 20 20 20 15 16 30 70 20 10 60 60 20 20 20 10 20 20 15 16 20 20 60 76 70 70 20 20 20 21 22  
84 84 84 84 84 84 84 85 23 24 23 24 20 11 12 13 14 10 10 10 20 20 20 20 71 30 70 20 10 60 60 20 80 87 87 87 87 87 82 20 20 20 77 70 70 20 70 60 23 24  
84 84 84 84 84 84 84 85 15 16 15 16 30 13 14 15 16 80 87 87 87 87 87 87 87 87 87 87 87 87 87 87 92 84 84 84 84 84 90 87 82 10 78 11 12 20 20 20 15 16 
84 84 84 84 84 84 84 90 87 87 87 87 82 15 16 80 87 92 84 84 84 84 84 84 84 84 84 84 84 84 84 84 84 84 84 84 84 84 84 84 90 82 71 13 14 11 12 50 30 30 
84 84 84 84 84 84 84 84 84 84 84 84 90 87 87 92 84 84 84 84 84 84 84 84 84 84 84 84 84 84 84 84 84 84 84 84 84 84 84 84 84 90 82 15 16 13 14 50 11 12  
84 84 84 84 84 84 84 84 84 84 84 84 84 84 84 84 84 84 84 84 84 84 84 84 84 84 84 84 84 84 84 84 84 84 84 84 84 84 84 84 84 84 90 82 70 15 16 50 13 14 
84 84 84 84 84 84 84 84 84 84 84 84 84 84 84 84 84 84 84 84 84 84 84 84 84 84 84 84 84 84 84 84 84 84 84 84 84 84 84 84 84 84 84 90 87 82 71 10 21 22 
84 84 84 84 84 84 84 84 84 84 84 84 84 84 84 84 84 84 84 84 84 84 84 84 84 84 84 84 84 84 84 84 84 84 84 84 84 84 84 84 84 84 84 84 84 90 82 10 23 24 
84 84 84 84 84 84 84 84 84 84 84 84 84 84 84 84 84 84 84 84 84 84 84 84 84 84 84 84 84 84 84 84 84 84 84 84 84 84 84 84 84 84 84 84 84 84 90 82 15 16 
84 84 84 84 84 84 84 84 84 84 84 84 84 84 84 84 84 84 84 84 84 84 84 84 84 84 84 84 84 84 84 84 84 84 84 84 84 84 84 84 84 84 84 84 84 84 84 90 87 87 